#################################################################
#       #       #       #       #       #       #       #       #
# @ #   #   #       #   #   #       #   #   #       #   #   #   #
#   #   #   #   #   #   #   #   #   #   #   #   #   #   #   #   #
#   #   #   #   #   #   #   #   #   #   #   #   #   #   #   #   #
#   #   #   #   #   #   #   #   #   #   #   #   #   #   #   #   #
#   #   #   #   #   #   #   #   #   #   #   #   #   #   #   #   #
#   #   #   #   #   #   #   #   #   #   #   #   #   #   #   #   #
#   #       #   #   #       #   #   #       #   #   #       #   #
#       #       #       #       #       #       #       #       #
#################################################################